month,airline_id,unique_carrier,carrier,carrier_name,carrier_group_new,sdomt_gallons,satl_gallons,spac_gallons,slat_gallons,sint_gallons,ts_gallons,tdomt_gallons,tint_gallons,total_gallons,sdomt_cost,satl_cost,spac_cost,slat_cost,sint_cost,ts_cost,tdomt_cost,tint_cost,total_cost,year
1,21161,09Q,09Q,"Swift Air, LLC d/b/a Eastern Air Lines d/b/a Eastern",2,0,0,0,0,0,0,581221,653989,1235210,0,0,0,0,0,0,1831212,1618745,3449957,2019
1,21352,0WQ,0WQ,Avjet Corporation,1,0,0,0,0,0,0,0,0,0,0,0,0,0,0,0,0,0,0,2019
1,21492,1BQ,1BQ,"Eastern Airlines f/k/a Dynamic Airways, LLC",1,0,0,0,0,0,0,35325,25496,60821,0,0,0,0,0,0,102795,74193,176988,2019
1,21652,27Q,27Q,"Jet Aviation Flight Services, Inc.",1,0,0,0,0,0,0,0,0,0,0,0,0,0,0,0,0,0,0,2019
1,21712,2HQ,2HQ,Elite Airways LLC,1,66815,0,0,0,0,66815,410186,0,410186,175499,0,0,0,0,175499,1518919,0,1518919,2019
1,21974,3EQ,3EQ,"Scott Aviation, LLC  d/b/a  Silver Air",1,0,0,0,0,0,0,0,0,0,0,0,0,0,0,0,0,0,0,2019
1,20408,5V,5V,Tatonduk Outfitters Limited d/b/a Everts Air Alaska and Everts Air Cargo,1,287034,0,0,0,0,287034,304851,0,304851,746126,0,0,0,0,746126,792440,0,792440,2019
1,19917,5X,5X,United Parcel Service,3,41673000,12332000,16238000,2967000,31537000,73210000,41673000,31537000,73210000,75938000,22394000,29385000,5845000,57624000,133562000,75938000,57624000,133562000,2019
1,20007,5Y,5Y,Atlas Air Inc.,3,0,0,0,0,0,0,14285985,30124140,44410125,0,0,0,0,0,0,30473337,61310144,91783481,2019
1,19874,8C,8C,Air Transport International,2,0,0,0,0,0,0,23622,742229,765851,0,0,0,0,0,0,43613,1910733,1954346,2019
1,20363,9E,9E,Endeavor Air Inc.,2,0,0,0,0,0,0,0,0,0,0,0,0,0,0,0,0,0,0,2019
1,20190,9S,9S,Southern Air Inc.,2,879987,2095479,3874541,0,5970020,6850007,879987,5970020,6850007,1839813,4762196,7207014,0,11969210,13809023,1839813,11969210,13809023,2019
1,19805,AA,AA,American Airlines Inc.,3,181805365,35379724,19744574,48979198,104103496,285908861,182280559,104264171,286544730,330993694,65177657,36092606,94494528,195764791,526758485,331867432,196062834,527930266,2019
1,20453,ABX,ABX,ABX Air Inc,2,229897,0,0,0,0,229897,229897,0,229897,443700,0,0,0,0,443700,443700,0,443700,2019
1,19930,AS,AS,Alaska Airlines Inc.,3,55801380,0,0,1202557,1202557,57003937,55881608,1202557,57084165,114278887,0,0,2867163,2867163,117146050,114428031,2867163,117295194,2019
1,20409,B6,B6,JetBlue Airways,3,55214112,0,0,15194099,15194099,70408211,55214112,15194099,70408211,107587447,0,0,29606459,29606459,137193906,107587447,29606459,137193906,2019
1,21167,CP,CP,Compass Airlines,2,0,0,0,0,0,0,0,0,0,0,0,0,0,0,0,0,0,0,2019
1,19790,DL,DL,Delta Air Lines Inc.,3,165835898,48129821,28376721,29135082,105641624,271477522,167883633,105823230,273706863,340011832,98680134,58180533,59735394,216596061,556607893,345424031,216968407,562392438,2019
1,20366,EV,EV,ExpressJet Airlines Inc.,2,0,0,0,0,0,0,0,0,0,0,0,0,0,0,0,0,0,0,2019
1,20436,F9,F9,Frontier Airlines Inc.,3,19219538,0,0,2622943,2622943,21842481,19219538,2622943,21842481,33033803,0,0,4629668,4629668,37663471,33033803,4629668,37663471,2019
1,20107,FX,FX,Federal Express Corporation,3,61502329,14334224,21909780,1984964,38228968,99731297,63304927,39128919,102433846,111194000,26208000,39844000,4174000,70226000,181420000,114483000,72218000,186701000,2019
1,20368,G4,G4,Allegiant Air,3,12442727,0,0,0,0,12442727,12704100,79969,12784069,24884405,0,0,0,0,24884405,25451228,174212,25625440,2019
1,20500,G7,G7,GoJet Airlines LLC d/b/a United Express,2,0,0,0,0,0,0,0,0,0,0,0,0,0,0,0,0,0,0,2019
1,20166,GFQ,GFQ,Gulf And Caribbean Cargo,1,0,0,0,0,0,0,209031,149862,358893,0,0,0,0,0,0,525709,384656,910365,2019
1,20402,GL,GL,Miami Air International,2,0,0,0,0,0,0,471431,148428,619859,0,0,0,0,0,0,1315825,414285,1730110,2019
1,19690,HA,HA,Hawaiian Airlines Inc.,3,15257659,0,7346463,0,7346463,22604122,15280124,7346463,22626587,27092396,0,12857142,0,12857142,39949538,27129872,12857142,39987014,2019
1,20370,KAQ,KAQ,Kalitta Air LLC,2,0,0,0,0,0,0,1444216,3970232,5414448,0,0,0,0,0,0,3030143,9034418,12064561,2019
1,21629,KD,KD,Western Global,2,0,0,0,0,0,0,1404278,1361512,2765790,0,0,0,0,0,0,2693455,1751966,4445421,2019
1,21634,KH,KH,Aloha Air Cargo,2,432202,0,0,0,0,432202,432202,0,432202,863451,0,0,0,0,863451,863451,0,863451,2019
1,20372,KLQ,KLQ,Kalitta Charters II,1,0,0,0,0,0,0,67948,124783,192731,0,0,0,0,0,0,192105,348416,540521,2019
1,20169,L2,L2,Lynden Air Cargo Airlines,1,96124,0,0,0,0,96124,174531,25265,199796,209803,0,0,0,0,209803,425821,75490,501311,2019
1,20151,M6,M6,Amerijet International,2,0,0,0,995280,995280,995280,513000,1259892,1772892,0,0,0,1985393,1985393,1985393,1023337,2513244,3536581,2019
1,20398,MQ,MQ,Envoy Air,3,0,0,0,0,0,0,0,0,0,0,0,0,0,0,0,0,0,0,2019
1,20405,N8,N8,National Air Cargo Group Inc d/ba National Airlines,2,0,0,0,0,0,0,67058,730951,798009,0,0,0,0,0,0,225990,2182806,2408796,2019
1,20108,NC,NC,Northern Air Cargo Inc.,1,336228,0,0,0,0,336228,388494,0,388494,661891,0,0,0,0,661891,762275,0,762275,2019
1,20416,NK,NK,Spirit Air Lines,3,31236251,0,0,4626264,4626264,35862515,31236251,4626264,35862515,62051998,0,0,9190250,9190250,71242248,62051998,9190250,71242248,2019
1,20397,OH,OH,PSA Airlines Inc.,2,0,0,0,0,0,0,0,0,0,0,0,0,0,0,0,0,0,0,2019
1,20304,OO,OO,SkyWest Airlines Inc.,3,8150037,0,0,0,0,8150037,8150037,0,8150037,17779528,0,0,0,0,17779528,17779528,0,17779528,2019
1,20177,PFQ,PFQ,Asia Pacific,1,0,0,0,0,0,0,0,330575,330575,0,0,0,0,0,0,0,640575,640575,2019
1,20100,PO,PO,Polar Air Cargo Airways,3,3095682,731689,13380503,0,14112192,17207874,3095682,14112192,17207874,5600244,1626373,22917040,0,24543413,30143657,5600244,24543413,30143657,2019
1,19687,QX,QX,Horizon Air,2,0,0,0,0,0,0,0,0,0,0,0,0,0,0,0,0,0,0,2019
1,20422,SY,SY,Sun Country Airlines d/b/a MN Airlines,2,3603825,0,0,1228302,1228302,4832127,4116225,1344257,,7127230,0,0,2630245,2630245,9757475,9034510,2861737,11896247,2019
1,20447,U7,U7,USA Jet Airlines Inc.,2,0,0,0,0,0,0,467799,39870,507669,0,0,0,0,0,0,860549,167956,1028505,2019
1,19977,UA,UA,United Air Lines Inc.,3,127590604,53538012,55192482,32518620,141249114,268839718,128594032,141518914,270112946,234726719,98041019,102255125,63335233,263631377,498358096,236590640,264119815,500710455,2019
1,20195,WI,WI,Sky Lease Cargo,2,0,0,0,0,0,0,0,1329432,1329432,0,0,0,0,0,0,0,2664398,2664398,2019
1,20310,WL,WL,"Caribbean Sun Airlines, Inc. d/b/a World Atlantic Airlines",1,0,0,0,0,0,0,47941,0,47941,0,0,0,0,0,0,141256,0,141256,2019
1,20377,X9,X9,Omni Air International LLC,2,0,0,0,0,0,0,431442,3654782,4086224,0,0,0,0,0,0,905436,10495937,11401373,2019
1,20207,XP,XP,XTRA Airways,1,0,0,0,0,0,0,2501,0,2501,0,0,0,0,0,0,8341,0,8341,2019
1,20378,YV,YV,Mesa Airlines Inc.,2,0,0,0,0,0,0,0,0,0,0,0,0,0,0,0,0,0,0,2019
1,20452,YX,YX,Republic Airline,3,20121,0,0,0,0,20121,20121,0,20121,43183,0,0,0,0,43183,43183,0,43183,2019
1,19393,WN,WN,Southwest Airlines Co.,3,162877133,0,0,1789759,1789759,164666892,163091949,1789759,164881708,311257985,0,0,4071037,4071037,315329022,311660539,4071037,315731576,2019
2,21161,09Q,09Q,"Swift Air, LLC d/b/a Eastern Air Lines d/b/a Eastern",2,0,0,0,0,0,0,473629,703692,1177321,0,0,0,0,0,0,1719142,1330481,3049623,2019
2,21352,0WQ,0WQ,Avjet Corporation,1,0,0,0,0,0,0,0,0,0,0,0,0,0,0,0,0,0,0,2019
2,21492,1BQ,1BQ,"Eastern Airlines f/k/a Dynamic Airways, LLC",1,0,0,0,0,0,0,10306,10838,21144,0,0,0,0,0,0,28651,30130,58781,2019
2,21652,27Q,27Q,"Jet Aviation Flight Services, Inc.",1,0,0,0,0,0,0,0,0,0,0,0,0,0,0,0,0,0,0,2019
2,21712,2HQ,2HQ,Elite Airways LLC,1,56789,0,0,0,0,56789,380855,0,380855,166382,0,0,0,0,166382,1485395,0,1485395,2019
2,21974,3EQ,3EQ,"Scott Aviation, LLC  d/b/a  Silver Air",1,0,0,0,0,0,0,0,0,0,0,0,0,0,0,0,0,0,0,2019
2,20408,5V,5V,Tatonduk Outfitters Limited d/b/a Everts Air Alaska and Everts Air Cargo,1,232268,0,0,0,0,232268,274605,0,274605,636845,0,0,0,0,636845,752926,0,752926,2019
2,19917,5X,5X,United Parcel Service,3,37155000,10576000,10951000,2930000,24457000,61612000,37155000,24457000,61612000,72268000,20252000,20399000,6093000,46744000,119012000,72268000,46744000,119012000,2019
2,20007,5Y,5Y,Atlas Air Inc.,3,0,0,0,0,0,0,5925931,31971559,37897490,0,0,0,0,0,0,13017193,65417799,78434992,2019
2,19874,8C,8C,Air Transport International,2,0,0,0,0,0,0,10945,668700,679645,0,0,0,0,0,0,31288,1749284,1780572,2019
2,20363,9E,9E,Endeavor Air Inc.,2,0,0,0,0,0,0,0,0,0,0,0,0,0,0,0,0,0,0,2019
2,20190,9S,9S,Southern Air Inc.,2,766074,2306492,3084112,2433,5393037,6159111,766074,5393037,6159111,1630575,4868978,6396131,4423,11269532,12900107,1630575,11269532,12900107,2019
2,19805,AA,AA,American Airlines Inc.,3,171404503,30958800,17322712,44034884,92316396,263720899,171809048,92477489,264286537,327026752,59435663,32573780,86843048,178852491,505879243,327810856,179178991,506989847,2019
2,20453,ABX,ABX,ABX Air Inc,2,147714,0,0,0,0,147714,147714,0,147714,0,0,0,0,0,0,0,0,0,2019
2,19930,AS,AS,Alaska Airlines Inc.,3,50051046,0,0,1189785,1189785,51240831,50121660,1189785,51311445,107264474,0,0,3017190,3017190,110281664,107399929,3017190,110417119,2019
2,20409,B6,B6,JetBlue Airways,3,52642699,0,0,13782584,13782584,66425283,52645386,13782584,66427970,108554374,0,0,28421031,28421031,136975405,108559925,28421031,136980956,2019
2,21167,CP,CP,Compass Airlines,2,0,0,0,0,0,0,0,0,0,0,0,0,0,0,0,0,0,0,2019
2,19790,DL,DL,Delta Air Lines Inc.,3,152322966,42273867,24710323,26290073,93274263,245597229,154407088,93667362,248074450,313961048,87132937,50931775,54187883,192252595,506213643,319361813,193062831,512424644,2019
2,20436,F9,F9,Frontier Airlines Inc.,3,17536368,0,0,2546226,2546226,20082594,17536368,2546226,20082594,34472192,0,0,4986355,4986355,39458547,34472192,4986355,39458547,2019
2,20107,FX,FX,Federal Express Corporation,3,55621824,13088387,18142095,1814495,33044977,88666801,57413610,33859713,91273323,107603000,25317000,34071000,4001000,63389000,170992000,111096633,65173000,176269633,2019
2,20368,G4,G4,Allegiant Air,3,13512627,0,0,0,0,13512627,13869284,121194,13990478,29175127,0,0,0,0,29175127,30035295,292448,30327743,2019
2,20500,G7,G7,GoJet Airlines LLC d/b/a United Express,2,0,0,0,0,0,0,0,0,0,0,0,0,0,0,0,0,0,0,2019
2,20166,GFQ,GFQ,Gulf And Caribbean Cargo,1,0,0,0,0,0,0,243903,82869,326772,0,0,0,0,0,0,635761,229579,865340,2019
2,20402,GL,GL,Miami Air International,2,0,0,0,0,0,0,480858,242533,723391,0,0,0,0,0,0,1399624,705936,2105560,2019
2,19690,HA,HA,Hawaiian Airlines Inc.,3,13532765,0,6418283,0,6418283,19951048,13532765,6418283,19951048,25862219,0,11806211,0,11806211,37668430,25862219,11806211,37668430,2019
2,20370,KAQ,KAQ,Kalitta Air LLC,2,0,0,0,0,0,0,1728042,3983371,5711413,0,0,0,0,0,0,3866084,9664349,13530433,2019
2,21629,KD,KD,Western Global,2,0,0,0,0,0,0,1579656,682988,2262644,0,0,0,0,0,0,3364687,1439034,4803721,2019
2,21634,KH,KH,Aloha Air Cargo,2,338518,0,0,0,0,338518,338518,0,338518,635575,0,0,0,0,635575,635575,0,635575,2019
2,20372,KLQ,KLQ,Kalitta Charters II,1,0,0,0,0,0,0,182000,33582,215582,0,0,0,0,0,0,461211,91078,552289,2019
2,20169,L2,L2,Lynden Air Cargo Airlines,1,88275,0,0,0,0,88275,119324,9368,128692,209784,0,0,0,0,209784,293751,22492,316243,2019
2,20151,M6,M6,Amerijet International,2,0,0,0,1273169,1273169,1273169,494687,1368318,1863005,0,0,0,2717366,2717366,2717366,1055826,2920446,3976272,2019
2,20398,MQ,MQ,Envoy Air,3,0,0,0,0,0,0,0,0,0,0,0,0,0,0,0,0,0,0,2019
2,20405,N8,N8,National Air Cargo Group Inc d/ba National Airlines,2,0,0,0,0,0,0,45744,258810,304554,0,0,0,0,0,0,160755,2701263,2862018,2019
2,20108,NC,NC,Northern Air Cargo Inc.,1,255741,0,0,0,0,255741,282780,0,282780,550182,0,0,0,0,550182,602185,0,602185,2019
2,20416,NK,NK,Spirit Air Lines,3,29560076,0,0,4030920,4030920,33590996,29560076,4030920,33590996,62838607,0,0,8568901,8568901,71407508,62838607,8568901,71407508,2019
2,20397,OH,OH,PSA Airlines Inc.,2,0,0,0,0,0,0,0,0,0,0,0,0,0,0,0,0,0,0,2019
2,20304,OO,OO,SkyWest Airlines Inc.,3,7503491,0,0,0,0,7503491,7503491,0,7503491,17050445,0,0,0,0,17050445,17050445,0,17050445,2019
2,20177,PFQ,PFQ,Asia Pacific,1,0,0,0,0,0,0,0,355981,355981,0,0,0,0,0,0,0,735012,735012,2019
2,20100,PO,PO,Polar Air Cargo Airways,3,2080351,470893,9936241,0,10407134,12487485,2080351,10407134,12487485,4008576,1039859,17494774,0,18534633,22543209,4008576,18534633,22543209,2019
2,19687,QX,QX,Horizon Air,2,0,0,0,0,0,0,0,0,0,0,0,0,0,0,0,0,0,0,2019
2,20422,SY,SY,Sun Country Airlines d/b/a MN Airlines,2,3730042,0,0,1725278,1725278,5455320,4229974,1836456,6066430,8041181,0,0,4024835,4024835,12066016,9890673,4266112,14156785,2019
2,20447,U7,U7,USA Jet Airlines Inc.,2,0,0,0,0,0,0,482752,32144,514896,0,0,0,0,0,0,952822,134969,1087791,2019
2,19977,UA,UA,United Air Lines Inc.,3,119312158,47970572,47881165,28457222,124308959,243621117,120087215,124665157,244752372,229838806,91564050,91129457,58249915,240943422,470782228,231327828,241611991,472939819,2019
2,20195,WI,WI,Sky Lease Cargo,2,0,0,0,0,0,0,0,982250,982250,0,0,0,0,0,0,0,2064254,2064254,2019
2,20310,WL,WL,"Caribbean Sun Airlines, Inc. d/b/a World Atlantic Airlines",1,0,0,0,0,0,0,26298,0,26298,0,0,0,0,0,0,69192,0,69192,2019
2,20377,X9,X9,Omni Air International LLC,2,0,0,0,0,0,0,370322,3235578,3605900,0,0,0,0,0,0,824611,8179604,9004215,2019
2,20207,XP,XP,XTRA Airways,1,0,0,0,0,0,0,2851,0,2851,0,0,0,0,0,0,9832,0,9832,2019
2,20378,YV,YV,Mesa Airlines Inc.,2,0,0,0,0,0,0,0,0,0,0,0,0,0,0,0,0,0,0,2019
2,20452,YX,YX,Republic Airline,3,41318,0,0,0,0,41318,41318,0,41318,85698,0,0,0,0,85698,85698,0,85698,2019
2,19393,WN,WN,Southwest Airlines Co.,3,146808596,0,0,1759751,1759751,148568347,146910807,1759751,148670558,289139878,0,0,4222874,4222874,293362752,289336674,4222874,293559548,2019
3,21161,09Q,09Q,"Swift Air, LLC d/b/a Eastern Air Lines d/b/a Eastern",2,0,0,0,0,0,0,796100,626848,1422948,0,0,0,0,0,0,2721022,1852717,4573739,2019
3,21352,0WQ,0WQ,Avjet Corporation,1,0,0,0,0,0,0,0,0,0,0,0,0,0,0,0,0,0,0,2019
3,21492,1BQ,1BQ,"Eastern Airlines f/k/a Dynamic Airways, LLC",1,0,0,0,0,0,0,7775,19521,27296,0,0,0,0,0,0,17961,45093,63054,2019
3,21652,27Q,27Q,"Jet Aviation Flight Services, Inc.",1,0,0,0,0,0,0,0,0,0,0,0,0,0,0,0,0,0,0,2019
3,21712,2HQ,2HQ,Elite Airways LLC,1,72228,0,0,0,0,72228,380854,0,380854,197885,0,0,0,0,197885,1466979,0,1466979,2019
3,21974,3EQ,3EQ,"Scott Aviation, LLC  d/b/a  Silver Air",1,0,0,0,0,0,0,0,0,0,0,0,0,0,0,0,0,0,0,2019
3,20408,5V,5V,Tatonduk Outfitters Limited d/b/a Everts Air Alaska and Everts Air Cargo,1,313346,0,0,0,0,313346,375331,0,375331,901770,0,0,0,0,901770,1080156,0,1080156,2019
3,19917,5X,5X,United Parcel Service,3,39076000,11813000,16555000,2772000,31140000,70216000,39076000,31140000,70216000,78171000,23391000,32977000,5885000,62253000,140424000,78171000,62253000,140424000,2019
3,20007,5Y,5Y,Atlas Air Inc.,3,0,0,0,0,0,0,15305509,35370667,50676176,0,0,0,0,0,0,33606169,80421617,114027786,2019
3,19874,8C,8C,Air Transport International,2,0,0,0,0,0,0,9158,693883,703041,0,0,0,0,0,0,26141,1602941,1629082,2019
3,20363,9E,9E,Endeavor Air Inc.,2,0,0,0,0,0,0,0,0,0,0,0,0,0,0,0,0,0,0,2019
3,20190,9S,9S,Southern Air Inc.,2,1132125,2270891,4202599,11610,6485100,7617225,1132125,6485100,7617225,2452661,5438549,9316333,23597,14778479,17231140,2452661,14778479,17231140,2019
3,19805,AA,AA,American Airlines Inc.,3,193300520,39602165,18989484,49281517,107873166,301173686,193844696,108126311,301971007,377335558,78539440,37331130,100988984,216859554,594195112,378410499,217383476,595793975,2019
3,20453,ABX,ABX,ABX Air Inc,2,134567,0,0,0,0,134567,134567,0,134567,0,0,0,0,0,0,0,0,0,2019
3,19930,AS,AS,Alaska Airlines Inc.,3,59205964,0,0,1342907,1342907,60548871,59266999,1342907,60609906,131021319,0,0,3487341,3487341,134508660,131141759,3487341,134629100,2019
3,20409,B6,B6,JetBlue Airways,3,60110558,0,0,16281212,16281212,76391770,60118439,16281212,76399651,128192313,0,0,34721459,34721459,162913772,128209025,34721459,162930484,2019
3,21167,CP,CP,Compass Airlines,2,0,0,0,0,0,0,0,0,0,0,0,0,0,0,0,0,0,0,2019
3,19790,DL,DL,Delta Air Lines Inc.,3,187116451,51208157,29039222,29626719,109874098,296990549,189695114,110256891,299952005,379215596,103779928,58851724,60042363,222674015,601889611,385807332,223449795,609257127,2019
3,20366,EV,EV,ExpressJet Airlines Inc.,2,0,0,0,0,0,0,0,0,0,0,0,0,0,0,0,0,0,0,2019
3,20436,F9,F9,Frontier Airlines Inc.,3,19844056,0,0,2296146,2296146,22140202,19844056,2296146,22140202,38296243,0,0,4598255,4598255,42894498,38296243,4598255,42894498,2019
3,20107,FX,FX,Federal Express Corporation,3,59597384,14946076,21935646,1954871,38836593,98433977,61495565,39837097,101332662,117707000,29910000,43924000,4462000,78296000,196003000,121522000,80634514,202156514,2019
3,20368,G4,G4,Allegiant Air,3,19112504,0,0,0,0,19112504,19457496,241511,19699007,42155397,0,0,0,0,42155397,42946254,573890,43520144,2019
3,20500,G7,G7,GoJet Airlines LLC d/b/a United Express,2,0,0,0,0,0,0,0,0,0,0,0,0,0,0,0,0,0,0,2019
3,20166,GFQ,GFQ,Gulf And Caribbean Cargo,1,0,0,0,0,0,0,271265,118131,389396,0,0,0,0,0,0,707757,328423,1036180,2019
3,20402,GL,GL,Miami Air International,2,0,0,0,0,0,0,535031,409667,944698,0,0,0,0,0,0,1510093,1156258,2666351,2019
3,19690,HA,HA,Hawaiian Airlines Inc.,3,15074904,0,6868252,0,6868252,21943156,15074904,6868252,21943156,29926149,0,13490935,0,13490935,43417084,29926149,13490935,43417084,2019
3,20370,KAQ,KAQ,Kalitta Air LLC,2,0,0,0,0,0,0,2850738,4086355,6937093,0,0,0,0,0,0,6114511,10033932,16148443,2019
3,21629,KD,KD,Western Global,2,0,0,0,0,0,0,1757258,1498463,3255721,0,0,0,0,0,0,3799780,1891764,5691544,2019
3,21634,KH,KH,Aloha Air Cargo,2,388491,0,0,0,0,388491,388491,0,388491,770139,0,0,0,0,770139,770139,0,770139,2019
3,20372,KLQ,KLQ,Kalitta Charters II,1,0,0,0,0,0,0,353642,5761,359403,0,0,0,0,0,0,895857,14948,910805,2019
3,20169,L2,L2,Lynden Air Cargo Airlines,1,101751,0,0,0,0,101751,186550,0,186550,249880,0,0,0,0,249880,487617,0,487617,2019
3,20151,M6,M6,Amerijet International,2,0,0,0,1542592,1542592,1542592,571030,1757801,2328831,0,0,0,3380082,3380082,3380082,1251224,3851642,5102866,2019
3,20398,MQ,MQ,Envoy Air,3,0,0,0,0,0,0,0,0,0,0,0,0,0,0,0,0,0,0,2019
3,20405,N8,N8,National Air Cargo Group Inc d/ba National Airlines,2,0,0,0,0,0,0,108920,1025984,1134904,0,0,0,0,0,0,413110,3086189,3499299,2019
3,20108,NC,NC,Northern Air Cargo Inc.,1,279333,0,0,0,0,279333,328645,0,328645,613337,0,0,0,0,613337,723951,0,723951,2019
3,20416,NK,NK,Spirit Air Lines,3,35893084,0,0,4481589,4481589,40374673,35893084,4481589,40374673,77330846,0,0,9655482,9655482,86986328,77330846,9655482,86986328,2019
3,20397,OH,OH,PSA Airlines Inc.,2,0,0,0,0,0,0,0,0,0,0,0,0,0,0,0,0,0,0,2019
3,20304,OO,OO,SkyWest Airlines Inc.,3,8558824,0,0,0,0,8558824,8558824,0,8558824,20654129,0,0,0,0,20654129,20654129,0,20654129,2019
3,20177,PFQ,PFQ,Asia Pacific,1,0,0,0,0,0,0,0,368456,368456,0,0,0,0,0,0,0,856040,856040,2019
3,20100,PO,PO,Polar Air Cargo Airways,3,2855050,746847,12632848,0,13379695,16234745,2855050,13379695,16234745,5715144,1638605,23950550,0,25589155,31304299,5715144,25589155,31304299,2019
3,19687,QX,QX,Horizon Air,2,0,0,0,0,0,0,0,0,0,0,0,0,0,0,0,0,0,0,2019
3,20422,SY,SY,Sun Country Airlines d/b/a MN Airlines,2,4298659,0,0,2346265,2346265,6644924,5031559,2401549,7433108,9450123,0,0,5577475,5577475,15027598,12628918,5712762,18341680,2019
3,20447,U7,U7,USA Jet Airlines Inc.,2,0,0,0,0,0,0,740889,45376,786265,0,0,0,0,0,0,1496040,157033,1653073,2019
3,19977,UA,UA,United Air Lines Inc.,3,147713026,59512296,55608646,34000681,149121623,296834649,148464310,149383772,297848082,293660063,118095979,111813272,72117501,302026752,595686815,295178703,302550240,597728943,2019
3,20195,WI,WI,Sky Lease Cargo,2,0,0,0,0,0,0,0,1343397,1343397,0,0,0,0,0,0,0,2932536,2932536,2019
3,20310,WL,WL,"Caribbean Sun Airlines, Inc. d/b/a World Atlantic Airlines",1,0,0,0,0,0,0,54955,4135,59090,0,0,0,0,0,0,124385,9359,133744,2019
3,20377,X9,X9,Omni Air International LLC,2,0,0,0,0,0,0,546781,3383937,3930718,0,0,0,0,0,0,1419862,6522442,7942304,2019
3,20207,XP,XP,XTRA Airways,1,0,0,0,0,0,0,0,0,0,0,0,0,0,0,0,0,0,0,2019
3,20378,YV,YV,Mesa Airlines Inc.,2,0,0,0,0,0,0,0,0,0,0,0,0,0,0,0,0,0,0,2019
3,20452,YX,YX,Republic Airline,3,13935,0,0,0,0,13935,13935,0,13935,29768,0,0,0,0,29768,29768,0,29768,2019
3,19393,WN,WN,Southwest Airlines Co.,3,177681157,0,0,2488121,2488121,180169278,177789535,2488121,180277656,352911927,0,0,6073530,6073530,358985457,353137046,6073530,359210576,2019
4,21161,09Q,09Q,"Swift Air, LLC d/b/a Eastern Air Lines d/b/a Eastern",2,0,0,0,0,0,0,438847,573413,1012260,0,0,0,0,0,0,1519482,1110701,2630183,2019
4,21352,0WQ,0WQ,Avjet Corporation,1,0,0,0,0,0,0,0,0,0,0,0,0,0,0,0,0,0,0,2019
4,21492,1BQ,1BQ,"Eastern Airlines f/k/a Dynamic Airways, LLC",1,0,0,0,0,0,0,1458,33138,34596,0,0,0,0,0,0,7463,80526,87989,2019
4,21652,27Q,27Q,"Jet Aviation Flight Services, Inc.",1,0,0,0,0,0,0,0,0,0,0,0,0,0,0,0,0,0,0,2019
4,21712,2HQ,2HQ,Elite Airways LLC,1,108171,0,0,0,0,108171,257621,0,257621,292609,0,0,0,0,292609,890987,0,890987,2019
4,21974,3EQ,3EQ,"Scott Aviation, LLC  d/b/a  Silver Air",1,0,0,0,0,0,0,0,0,0,0,0,0,0,0,0,0,0,0,2019
4,20408,5V,5V,Tatonduk Outfitters Limited d/b/a Everts Air Alaska and Everts Air Cargo,1,293620,0,0,0,0,293620,333350,0,333350,821935,0,0,0,0,821935,933152,0,933152,2019
4,19917,5X,5X,United Parcel Service,3,40908000,11964000,16915000,3034000,31913000,72821000,40908000,31913000,72821000,84149000,23994000,34569000,6530000,65093000,149242000,84149000,65093000,149242000,2019
4,20007,5Y,5Y,Atlas Air Inc.,3,0,0,0,0,0,0,15865672,34294456,50160128,0,0,0,0,0,0,35939769,74764973,110704742,2019
4,19874,8C,8C,Air Transport International,2,0,0,0,0,0,0,313624,782826,1096450,0,0,0,0,0,0,38574,2020064,2058638,2019
4,20363,9E,9E,Endeavor Air Inc.,2,0,0,0,0,0,0,0,0,0,0,0,0,0,0,0,0,0,0,2019
4,20190,9S,9S,Southern Air Inc.,2,992362,2232567,4241516,0,6474083,7466445,992362,6474083,7466445,2221720,5212881,9035414,0,14248295,16470015,2221720,14248295,16470015,2019
4,19805,AA,AA,American Airlines Inc.,3,180184898,49277957,18132384,42916293,110326634,290511532,180567823,110440799,291008622,362560543,99573979,36677163,90155938,226407080,588967623,363320993,226648425,589969418,2019
4,20453,ABX,ABX,ABX Air Inc,2,194952,0,0,0,0,194952,194952,0,194952,0,0,0,0,0,0,0,0,0,2019
4,19930,AS,AS,Alaska Airlines Inc.,3,58372355,0,0,1293697,1293697,59666052,58432767,1293697,59726464,133673299,0,0,3411283,3411283,137084582,133797164,3411283,137208447,2019
4,20409,B6,B6,JetBlue Airways,3,59527739,0,0,15649373,15649373,75177112,59527739,15649373,75177112,128724788,0,0,33840732,33840732,162565520,128724788,33840732,162565520,2019
4,21167,CP,CP,Compass Airlines,2,0,0,0,0,0,0,0,0,0,0,0,0,0,0,0,0,0,0,2019
4,19790,DL,DL,Delta Air Lines Inc.,3,178154335,62537834,29643566,23576826,115758226,293912561,180070679,116040467,296111146,359449469,126178189,59809739,47569302,233557230,593006699,364498097,234126688,598624785,2019
4,20366,EV,EV,ExpressJet Airlines LLC,2,0,0,0,0,0,0,0,0,0,0,0,0,0,0,0,0,0,0,2019
4,20436,F9,F9,Frontier Airlines Inc.,3,19681831,0,0,1940677,1940677,21622508,19681831,1940677,21622508,38668884,0,0,4094706,4094706,42763590,38668884,4094706,42763590,2019
4,20107,FX,FX,Federal Express Corporation,3,56512179,15119466,22179883,1844567,39143916,95656095,58066815,39768042,97834857,114638000,30061000,44806000,4252000,79119000,193757000,117835000,80518000,198353000,2019
4,20368,G4,G4,Allegiant Air,3,16794117,0,0,0,0,16794117,17181795,207518,17389313,37653594,0,0,0,0,37653594,38555060,483463,39038523,2019
4,20500,G7,G7,GoJet Airlines LLC d/b/a United Express,2,0,0,0,0,0,0,0,0,0,0,0,0,0,0,0,0,0,0,2019
4,20166,GFQ,GFQ,Gulf And Caribbean Cargo,1,0,0,0,0,0,0,120666,124444,245110,0,0,0,0,0,0,307987,342835,650822,2019
4,20402,GL,GL,Miami Air International,2,0,0,0,0,0,0,200346,315308,515654,0,0,0,0,0,0,546281,859747,1406028,2019
4,19690,HA,HA,Hawaiian Airlines Inc.,3,15343204,0,6690692,0,6690692,22033896,15343204,6690692,22033896,31430036,0,13400043,0,13400043,44830079,31430036,13400043,44830079,2019
4,20370,KAQ,KAQ,Kalitta Air LLC,2,0,0,0,0,0,0,3221168,4524751,7745919,0,0,0,0,0,0,6897031,10854673,17751704,2019
4,21629,KD,KD,Western Global,2,0,0,0,0,0,0,1569264,892204,2461468,0,0,0,0,0,0,3415879,1930528,5346407,2019
4,21634,KH,KH,Aloha Air Cargo,2,392414,0,0,0,0,392414,392414,0,392414,793241,0,0,0,0,793241,793241,0,793241,2019
4,20372,KLQ,KLQ,Kalitta Charters II,1,0,0,0,0,0,0,198608,29459,228067,0,0,0,0,0,0,501851,77618,579469,2019
4,20169,L2,L2,Lynden Air Cargo Airlines,1,97484,0,0,0,0,97484,151911,15563,167474,248212,0,0,0,0,248212,375287,47958,423245,2019
4,20151,M6,M6,Amerijet International,2,0,0,0,1533857,1533857,1533857,554946,1716275,2271221,0,0,0,3465591,3465591,3465591,1253843,3877746,5131589,2019
4,20398,MQ,MQ,Envoy Air,3,0,0,0,0,0,0,0,0,0,0,0,0,0,0,0,0,0,0,2019
4,20405,N8,N8,National Air Cargo Group Inc d/ba National Airlines,2,0,0,0,0,0,0,74323,1357215,1431538,0,0,0,0,0,0,236905,3849238,4086143,2019
4,20108,NC,NC,Northern Air Cargo Inc.,1,271829,0,0,0,0,271829,322129,0,322129,603087,0,0,0,0,603087,697107,0,697107,2019
4,20416,NK,NK,Spirit Air Lines,3,33760047,0,0,4911255,4911255,38671302,33760047,4911255,38671302,74222807,0,0,10797590,10797590,85020397,74222807,10797590,85020397,2019
4,20397,OH,OH,PSA Airlines Inc.,2,0,0,0,0,0,0,0,0,0,0,0,0,0,0,0,0,0,0,2019
4,20304,OO,OO,SkyWest Airlines Inc.,3,8262780,0,0,0,0,8262780,8262780,0,8262780,20297087,0,0,0,0,20297087,20297087,0,20297087,2019
4,20177,PFQ,PFQ,Asia Pacific,1,0,0,0,0,0,0,0,389461,389461,0,0,0,0,0,0,0,900577,900577,2019
4,20100,PO,PO,Polar Air Cargo Airways,3,2399267,701876,10945472,0,11647348,14046615,2399267,11647348,14046615,4948050,1541758,21476395,0,23018153,27966203,4948050,23018153,27966203,2019
4,19687,QX,QX,Horizon Air,2,0,0,0,0,0,0,0,0,0,0,0,0,0,0,0,0,0,0,2019
4,20422,SY,SY,Sun Country Airlines d/b/a MN Airlines,2,4069973,0,0,987765,987765,5057738,4758911,1034854,5793765,8956181,0,0,2352138,2352138,11308319,11676816,2464930,14141746,2019
4,20447,U7,U7,USA Jet Airlines Inc.,2,0,0,0,0,0,0,276938,17958,294896,0,0,0,0,0,0,567626,62363,629989,2019
4,19977,UA,UA,United Air Lines Inc.,3,144590058,60523632,51831017,31206029,143560678,288150736,145411013,143673409,289084422,294430837,122350380,106637727,66383872,295371979,589802816,296103451,295602761,591706212,2019
4,20195,WI,WI,Sky Lease Cargo,2,0,0,0,0,0,0,0,1803776,1803776,0,0,0,0,0,0,0,4015883,4015883,2019
4,20310,WL,WL,"Caribbean Sun Airlines, Inc. d/b/a World Atlantic Airlines",1,0,0,0,0,0,0,78060,1268,79328,0,0,0,0,0,0,220182,3577,223759,2019
4,20377,X9,X9,Omni Air International LLC,2,0,0,0,0,0,0,395064,3622989,4018053,0,0,0,0,0,0,1065262,8945485,10010747,2019
4,20207,XP,XP,XTRA Airways,1,0,0,0,0,0,0,0,0,0,0,0,0,0,0,0,0,0,0,2019
4,20378,YV,YV,Mesa Airlines Inc.,2,0,0,0,0,0,0,0,0,0,0,0,0,0,0,0,0,0,0,2019
4,20452,YX,YX,Republic Airline,3,13919,0,0,0,0,13919,13919,0,13919,29889,0,0,0,0,29889,29889,0,29889,2019
4,19393,WN,WN,Southwest Airlines Co.,3,171401778,0,0,1931660,1931660,173333438,171492052,1931660,173423712,343356856,0,0,4787040,4787040,348143896,343556447,4787040,348343487,2019
5,21161,09Q,09Q,"Swift Air, LLC d/b/a Eastern Air Lines d/b/a Eastern",2,0,0,0,0,0,0,675825,757128,1432953,0,0,0,0,0,0,1744273,1120059,2864332,2019
5,21352,0WQ,0WQ,Avjet Corporation,1,0,0,0,0,0,0,0,0,0,0,0,0,0,0,0,0,0,0,2019
5,21492,1BQ,1BQ,"Eastern Airlines f/k/a Dynamic Airways, LLC",1,0,0,0,0,0,0,0,21082,21082,0,0,0,0,0,0,0,79229,79229,2019
5,21652,27Q,27Q,"Jet Aviation Flight Services, Inc.",1,0,0,0,0,0,0,0,0,0,0,0,0,0,0,0,0,0,0,2019
5,21712,2HQ,2HQ,Elite Airways LLC,1,165353,0,0,0,0,165353,273216,0,273216,619426,0,0,0,0,619426,941715,0,941715,2019
5,21974,3EQ,3EQ,"Scott Aviation, LLC  d/b/a  Silver Air",1,0,0,0,0,0,0,0,0,0,0,0,0,0,0,0,0,0,0,2019
5,20408,5V,5V,Tatonduk Outfitters Limited d/b/a Everts Air Alaska and Everts Air Cargo,1,326698,0,0,0,0,326698,366102,0,366102,924717,0,0,0,0,924717,1036250,0,1036250,2019
5,19917,5X,5X,United Parcel Service,3,42867000,12352000,17383000,3093000,32828000,75695000,42867000,32828000,75695000,90692000,25298000,36826000,6761000,68885000,159577000,90692000,68885000,159577000,2019
5,20007,5Y,5Y,Atlas Air Inc.,3,0,0,0,0,0,0,16247567,33279659,49527226,0,0,0,0,0,0,37213237,75650997,112864234,2019
5,19874,8C,8C,Air Transport International,2,0,0,0,0,0,0,59164,787542,846706,0,0,0,0,0,0,170069,2049934,2220003,2019
5,20363,9E,9E,Endeavor Air Inc.,2,0,0,0,0,0,0,0,0,0,0,0,0,0,0,0,0,0,0,2019
5,20190,9S,9S,Southern Air Inc.,2,1263017,2393561,4254975,0,6648536,7911553,1263017,6648536,7911553,2865185,5947372,9593079,0,15540451,18405636,2865185,15540451,18405636,2019
5,19805,AA,AA,American Airlines Inc.,3,195424647,61637649,19301832,43014750,123954231,319378878,195785035,124187098,319972133,400384570,126601880,40130901,92299450,259032231,659416801,401108088,259545007,660653095,2019
5,20453,ABX,ABX,ABX Air Inc,2,149718,0,0,0,0,149718,149718,0,149718,0,0,0,0,0,0,0,0,0,2019
5,19930,AS,AS,Alaska Airlines Inc.,3,61891326,0,0,846925,846925,62738251,61930261,846925,62777186,149060140,0,0,2331235,2331235,151391375,149141897,2331235,151473132,2019
5,20409,B6,B6,JetBlue Airways,3,59139308,0,0,15399970,15399970,74539278,59139308,15399970,74539278,132733065,0,0,34563901,34563901,167296966,132733065,34563901,167296966,2019
5,21167,CP,CP,Compass Airlines,2,0,0,0,0,0,0,0,0,0,0,0,0,0,0,0,0,0,0,2019
5,19790,DL,DL,Delta Air Lines Inc.,3,186758571,74949599,31995527,22808196,129753322,316511893,188366304,129806984,318173288,383651451,153966280,65727267,46854062,266547609,650199060,388155077,266657846,654812923,2019
5,20366,EV,EV,ExpressJet Airlines LLC,2,0,0,0,0,0,0,0,0,0,0,0,0,0,0,0,0,0,0,2019
5,20436,F9,F9,Frontier Airlines Inc.,3,22805754,0,0,1785895,1785895,24591649,22805754,1785895,24591649,42822137,0,0,3867858,3867858,46689995,42822137,3867858,46689995,2019
5,20107,FX,FX,Federal Express Corporation,3,60239135,16083295,23077883,2115040,41276218,101515353,62012233,42102155,104114388,125755000,32967000,48274000,4982000,86223000,211978000,129525000,88226000,217751000,2019
5,20368,G4,G4,Allegiant Air,3,15895717,0,0,0,0,15895717,16288199,206601,16494800,36874836,0,0,0,0,36874836,37843745,493218,38336963,2019
5,20500,G7,G7,GoJet Airlines LLC d/b/a United Express,2,0,0,0,0,0,0,0,0,0,0,0,0,0,0,0,0,0,0,2019
5,20166,GFQ,GFQ,Gulf And Caribbean Cargo,1,0,0,0,0,0,0,101151,110668,211819,0,0,0,0,0,0,264738,308875,573613,2019
5,20402,GL,GL,Miami Air International,2,0,0,0,0,0,0,153537,249455,402992,0,0,0,0,0,0,453072,736117,1189189,2019
5,19690,HA,HA,Hawaiian Airlines Inc.,3,16143998,0,6761601,0,6761601,22905599,16143998,6761601,22905599,34161814,0,13846292,0,13846292,48008106,34161814,13846292,48008106,2019
5,20370,KAQ,KAQ,Kalitta Air LLC,2,0,0,0,0,0,0,2757277,3733101,6490378,0,0,0,0,0,0,5976523,8986877,14963400,2019
5,21629,KD,KD,Western Global,2,0,0,0,0,0,0,1025832,1073257,2099089,0,0,0,0,0,0,2330691,2428578,4759269,2019
5,21634,KH,KH,Aloha Air Cargo,2,387931,0,0,0,0,387931,387931,0,387931,796746,0,0,0,0,796746,796746,0,796746,2019
5,20372,KLQ,KLQ,Kalitta Charters II,1,0,0,0,0,0,0,112766,43894,156660,0,0,0,0,0,0,298448,126383,424831,2019
5,20169,L2,L2,Lynden Air Cargo Airlines,1,131178,0,0,0,0,131178,285985,72421,358406,356252,0,0,0,0,356252,789250,86941,876191,2019
5,20151,M6,M6,Amerijet International,2,0,0,0,1736422,1736422,1736422,512239,1796706,2308945,0,0,0,3953951,3953951,3953951,1166403,4091222,5257625,2019
5,20398,MQ,MQ,Envoy Air,3,0,0,0,0,0,0,0,0,0,0,0,0,0,0,0,0,0,0,2019
5,20405,N8,N8,National Air Cargo Group Inc d/ba National Airlines,2,0,0,0,0,0,0,31001,1134112,1165113,0,0,0,0,0,0,114406,3347119,3461525,2019
5,20108,NC,NC,Northern Air Cargo Inc.,1,182675,0,0,0,0,182675,210015,0,210015,436829,0,0,0,0,436829,502062,0,502062,2019
5,20416,NK,NK,Spirit Air Lines,3,37152807,0,0,4970557,4970557,42123364,37152807,4970557,42123364,83576243,0,0,11181402,11181402,94757645,83576243,11181402,94757645,2019
5,20397,OH,OH,PSA Airlines Inc.,2,0,0,0,0,0,0,0,0,0,0,0,0,0,0,0,0,0,0,2019
5,20304,OO,OO,SkyWest Airlines Inc.,3,8838081,0,0,0,0,8838081,8838081,0,8838081,22436510,0,0,0,0,22436510,22436510,0,22436510,2019
5,20177,PFQ,PFQ,Asia Pacific,1,0,0,0,0,0,0,0,363290,363290,0,0,0,0,0,0,0,834670,834670,2019
5,20100,PO,PO,Polar Air Cargo Airways,3,2756574,722700,11759138,0,12481838,15238412,2756574,12481838,15238412,5758153,1613922,24108440,0,25722362,31480515,5758153,25722362,31480515,2019
5,19687,QX,QX,Horizon Air,2,0,0,0,0,0,0,0,0,0,0,0,0,0,0,0,0,0,0,2019
5,20422,SY,SY,Sun Country Airlines d/b/a MN Airlines,2,4023182,0,0,304836,304836,4328018,5044703,403404,5448107,9089834,0,0,755802,755802,9845636,11488221,996564,12484785,2019
5,20447,U7,U7,USA Jet Airlines Inc.,2,0,0,0,0,0,0,317305,9687,326992,0,0,0,0,0,0,686029,32703,718732,2019
5,19977,UA,UA,United Air Lines Inc.,3,153202004,73294536,54098845,27860083,155253464,308455468,153949739,155465624,309415363,322624581,152795530,115391388,60866483,329053401,651677982,324208102,329510626,653718728,2019
5,20195,WI,WI,Sky Lease Cargo,2,0,0,0,0,0,0,11147,1212285,1223432,0,0,0,0,0,0,26946,2730784,2757730,2019
5,20310,WL,WL,"Caribbean Sun Airlines, Inc. d/b/a World Atlantic Airlines",1,0,0,0,0,0,0,46985,247955,294940,0,0,0,0,0,0,89588,472786,562374,2019
5,20377,X9,X9,Omni Air International LLC,2,0,0,0,0,0,0,613723,2690826,3304549,0,0,0,0,0,0,1477851,6740872,8218723,2019
5,20207,XP,XP,XTRA Airways,1,0,0,0,0,0,0,0,0,0,0,0,0,0,0,0,0,0,0,2019
5,20378,YV,YV,Mesa Airlines Inc.,2,0,0,0,0,0,0,0,0,0,0,0,0,0,0,0,0,0,0,2019
5,20452,YX,YX,Republic Airline,3,18888,0,0,0,0,18888,18888,0,18888,41578,0,0,0,0,41578,41578,0,41578,2019
5,19393,WN,WN,Southwest Airlines Co.,3,177347813,0,0,2473278,2473278,179821091,177441553,2473278,179914831,371652892,0,0,6309955,6309955,377962847,371853619,6309955,378163574,2019
6,21161,09Q,09Q,"Swift Air, LLC d/b/a Eastern Air Lines d/b/a Eastern",2,0,0,0,0,0,0,401512,808223,1209735,0,0,0,0,0,0,877762,1742073,2619835,2019
6,21352,0WQ,0WQ,Avjet Corporation,1,0,0,0,0,0,0,0,0,0,0,0,0,0,0,0,0,0,0,2019
6,21492,1BQ,1BQ,"Eastern Airlines f/k/a Dynamic Airways, LLC",1,0,0,0,0,0,0,3864,70432,74296,0,0,0,0,0,0,18431,252722,271153,2019
6,21652,27Q,27Q,"Jet Aviation Flight Services, Inc.",1,0,0,0,0,0,0,0,0,0,0,0,0,0,0,0,0,0,0,2019
6,21712,2HQ,2HQ,Elite Airways LLC,1,110195,0,0,0,0,110195,168234,0,168234,311439,0,0,0,0,311439,493559,0,493559,2019
6,21974,3EQ,3EQ,"Scott Aviation, LLC  d/b/a  Silver Air",1,0,0,0,0,0,0,0,0,0,0,0,0,0,0,0,0,0,0,2019
6,20408,5V,5V,Tatonduk Outfitters Limited d/b/a Everts Air Alaska and Everts Air Cargo,1,301172,0,0,0,0,301172,355723,0,355723,782334,0,0,0,0,782334,924038,0,924038,2019
6,19917,5X,5X,United Parcel Service,3,40665000,12187000,16966000,2717000,31870000,72535000,40665000,31870000,72535000,77414000,23959000,34428000,5613000,64000000,141414000,77414000,64000000,141414000,2019
6,20007,5Y,5Y,Atlas Air Inc.,3,0,0,0,0,0,0,15732351,31496344,47228695,0,0,0,0,0,0,35076392,69904163,104980555,2019
6,19874,8C,8C,Air Transport International,2,0,0,0,0,0,0,43052,730813,773865,0,0,0,0,0,0,120829,1883667,2004496,2019
6,20363,9E,9E,Endeavor Air Inc.,2,0,0,0,0,0,0,0,0,0,0,0,0,0,0,0,0,0,0,2019
6,20190,9S,9S,Southern Air Inc.,2,1094965,2102642,3714691,2186,5819519,6914484,1094965,5819519,6914484,2409767,5182766,7919857,4005,13106628,15516395,2409767,13106628,15516395,2019
6,19805,AA,AA,American Airlines Inc.,3,195670252,67039590,19020928,45291083,131351601,327021853,195915483,131521720,327437203,373907739,130140181,37402156,94460076,262002413,635910152,374377915,262365817,636743732,2019
6,20453,ABX,ABX,ABX Air Inc,2,133419,0,0,0,0,133419,133419,0,133419,0,0,0,0,0,0,0,0,0,2019
6,19930,AS,AS,Alaska Airlines Inc.,3,63813286,0,0,678278,678278,64491564,63899921,678278,64578199,135821357,0,0,1666785,1666785,137488142,135989040,1666785,137655825,2019
6,20409,B6,B6,JetBlue Airways,3,57899767,0,0,16881416,16881416,74781183,57899767,16881416,74781183,119555227,0,0,34857852,34857852,154413079,119555227,34857852,154413079,2019
6,21167,CP,CP,Compass Airlines,2,0,0,0,0,0,0,0,0,0,0,0,0,0,0,0,0,0,0,2019
6,19790,DL,DL,Delta Air Lines Inc.,3,196666953,83530097,31788396,22790222,138108715,334775668,198074942,138108715,336183657,416406190,176859655,67306095,48254113,292419863,708826053,420444587,292419863,712864450,2019
6,20366,EV,EV,ExpressJet Airlines LLC,2,0,0,0,0,0,0,0,0,0,0,0,0,0,0,0,0,0,0,2019
6,20436,F9,F9,Frontier Airlines Inc.,3,22899112,0,0,1697218,1697218,24596330,22899112,1697218,24596330,41286065,0,0,3355771,3355771,44641836,41286065,3355771,44641836,2019
6,20107,FX,FX,Federal Express Corporation,3,55563857,14693105,22286076,1903348,38882529,94446386,56983007,39523503,96506510,103990000,28220000,45180000,4332000,77732000,181722000,106681494,79155000,185836494,2019
6,20368,G4,G4,Allegiant Air,3,19637023,0,0,0,0,19637023,19947115,232353,20179468,41412959,0,0,0,0,41412959,42106026,527704,42633730,2019
6,20500,G7,G7,GoJet Airlines LLC d/b/a United Express,2,0,0,0,0,0,0,0,0,0,0,0,0,0,0,0,0,0,0,2019
6,20166,GFQ,GFQ,Gulf And Caribbean Cargo,1,0,0,0,0,0,0,177454,75579,253033,0,0,0,0,0,0,447931,201992,649923,2019
6,20402,GL,GL,Miami Air International,2,0,0,0,0,0,0,149225,319809,469034,0,0,0,0,0,0,404431,866750,1271181,2019
6,19690,HA,HA,Hawaiian Airlines Inc.,3,15667787,0,6670038,0,6670038,22337825,15667787,6670038,22337825,29621947,0,12917461,0,12917461,42539408,29621947,12917461,42539408,2019
6,20370,KAQ,KAQ,Kalitta Air LLC,2,0,0,0,0,0,0,3052250,4644761,7697011,0,0,0,0,0,0,5945440,10508398,16453838,2019
6,21629,KD,KD,Western Global,2,0,0,0,0,0,0,1842149,1078869,2921018,0,0,0,0,0,0,3835839,2328684,6164523,2019
6,21634,KH,KH,Aloha Air Cargo,2,396366,0,0,0,0,396366,396366,0,396366,743516,0,0,0,0,743516,743516,0,743516,2019
6,20372,KLQ,KLQ,Kalitta Charters II,1,0,0,0,0,0,0,138345,9808,148153,0,0,0,0,0,0,380505,22377,402882,2019
6,20169,L2,L2,Lynden Air Cargo Airlines,1,185144,0,0,0,0,185144,336245,61566,397811,443441,0,0,0,0,443441,844329,196299,1040628,2019
6,20151,M6,M6,Amerijet International,2,0,0,0,1585401,1585401,1585401,500791,1690049,2190840,0,0,0,3426975,3426975,3426975,1082501,3653180,4735681,2019
6,20398,MQ,MQ,Envoy Air,3,0,0,0,0,0,0,0,0,0,0,0,0,0,0,0,0,0,0,2019
6,20405,N8,N8,National Air Cargo Group Inc d/ba National Airlines,2,0,0,0,0,0,0,110460,437315,547775,0,0,0,0,0,0,374003,1555405,1929408,2019
6,20108,NC,NC,Northern Air Cargo Inc.,1,259324,0,0,0,0,259324,407071,0,407071,507435,0,0,0,0,507435,787763,0,787763,2019
6,20416,NK,NK,Spirit Air Lines,3,36737363,0,0,4914976,4914976,41652339,36737363,4914976,41652339,75170578,0,0,10056835,10056835,85227413,75170578,10056835,85227413,2019
6,20397,OH,OH,PSA Airlines Inc.,2,0,0,0,0,0,0,0,0,0,0,0,0,0,0,0,0,0,0,2019
6,20304,OO,OO,SkyWest Airlines Inc.,3,8915291,0,0,0,0,8915291,8915291,0,8915291,20779214,0,0,0,0,20779214,20779214,0,20779214,2019
6,20177,PFQ,PFQ,Asia Pacific,1,0,0,0,0,0,0,0,333834,333834,0,0,0,0,0,0,0,765867,765867,2019
6,20100,PO,PO,Polar Air Cargo Airways,3,2980851,709842,11761339,0,12471181,15452032,2980851,12471181,15452032,5662856,1567724,23591976,0,25159700,30822556,5662856,25159700,30822556,2019
6,19687,QX,QX,Horizon Air,2,0,0,0,0,0,0,0,0,0,0,0,0,0,0,0,0,0,0,2019
6,20422,SY,SY,Sun Country Airlines d/b/a MN Airlines,2,5374879,0,0,911178,911178,6286057,6200681,968745,7169426,11081522,0,0,2135113,2135113,13216635,13077984,2267662,15345646,2019
6,20447,U7,U7,USA Jet Airlines Inc.,2,0,0,0,0,0,0,448144,14417,462561,0,0,0,0,0,0,899896,44743,944639,2019
6,19977,UA,UA,United Air Lines Inc.,3,158802116,75616971,53292139,31692487,160601597,319403713,159500662,160737489,320238151,306347461,147753982,106826039,65593766,320173787,626521248,307713727,320455909,628169636,2019
6,20195,WI,WI,Sky Lease Cargo,2,0,0,0,0,0,0,0,566138,566138,0,0,0,0,0,0,0,1189220,1189220,2019
6,20310,WL,WL,"Caribbean Sun Airlines, Inc. d/b/a World Atlantic Airlines",1,0,0,0,0,0,0,159403,134150,293553,0,0,0,0,0,0,253766,213564,467330,2019
6,20377,X9,X9,Omni Air International LLC,2,0,0,0,0,0,0,426101,3070130,3496231,0,0,0,0,0,0,934804,7368962,8303766,2019
6,20207,XP,XP,XTRA Airways,1,0,0,0,0,0,0,0,0,0,0,0,0,0,0,0,0,0,0,2019
6,20378,YV,YV,Mesa Airlines Inc.,2,0,0,0,0,0,0,0,0,0,0,0,0,0,0,0,0,0,0,2019
6,20452,YX,YX,Republic Airline,3,18137,0,0,0,0,18137,18137,0,18137,38021,0,0,0,0,38021,38021,0,38021,2019
6,19393,WN,WN,Southwest Airlines Co.,3,176316720,0,0,2713632,2713632,179030352,176417715,2713632,179131347,351393094,0,0,6375770,6375770,357768864,351593930,6375770,357969700,2019
7,21161,09Q,09Q,"Swift Air, LLC d/b/a Eastern Air Lines d/b/a Eastern",2,0,0,0,0,0,0,312166,2103361,2415527,0,0,0,0,0,0,1043401,1812328,2855729,2019
7,21352,0WQ,0WQ,Avjet Corporation,1,0,0,0,0,0,0,0,0,0,0,0,0,0,0,0,0,0,0,2019
7,21492,1BQ,1BQ,"Eastern Airlines f/k/a Dynamic Airways, LLC",1,0,0,0,0,0,0,4053,62740,66793,0,0,0,0,0,0,15848,169033,184881,2019
7,21652,27Q,27Q,"Jet Aviation Flight Services, Inc.",1,0,0,0,0,0,0,0,0,0,0,0,0,0,0,0,0,0,0,2019
7,21712,2HQ,2HQ,Elite Airways LLC,1,109064,0,0,0,0,109064,157065,0,157065,308439,0,0,0,0,308439,500082,0,500082,2019
7,21974,3EQ,3EQ,"Scott Aviation, LLC  d/b/a  Silver Air",1,0,0,0,0,0,0,0,0,0,0,0,0,0,0,0,0,0,0,2019
7,20408,5V,5V,Tatonduk Outfitters Limited d/b/a Everts Air Alaska and Everts Air Cargo,1,390874,0,0,0,0,390874,426753,0,426753,1015464,0,0,0,0,1015464,1114248,0,1114248,2019
7,19917,5X,5X,United Parcel Service,3,45011000,12242000,18078000,2880000,33200000,78211000,45011000,33200000,78211000,88737000,23379000,34914000,6038000,64331000,153068000,88737000,64331000,153068000,2019
7,20007,5Y,5Y,Atlas Air Inc.,3,0,0,0,0,0,0,16123997,34078678,50202675,0,0,0,0,0,0,36371051,76224609,112595660,2019
7,19874,8C,8C,Air Transport International,2,0,0,0,0,0,0,47205,812855,860060,0,0,0,0,0,0,129601,2172139,2301740,2019
7,20363,9E,9E,Endeavor Air Inc.,2,0,0,0,0,0,0,0,0,0,0,0,0,0,0,0,0,0,0,2019
7,20190,9S,9S,Southern Air Inc.,2,1227334,2293129,4301038,0,6594167,7821501,1227334,6594167,7821501,2734807,5379671,9087076,0,14466747,17201554,2734807,14466747,17201554,2019
7,19805,AA,AA,American Airlines Inc.,3,200601221,70341415,20023724,47225419,137590558,338191779,200831199,137763844,338595043,385858147,136632087,38137388,97101514,271870989,657729136,386300528,272226731,658527259,2019
7,20453,ABX,ABX,ABX Air Inc,2,158928,0,0,0,0,158928,158928,0,158928,0,0,0,0,0,0,0,0,0,2019
7,19930,AS,AS,Alaska Airlines Inc.,3,66937916,0,0,623643,623643,67561559,66996749,623643,67620392,145117185,0,0,1576430,1576430,146693615,145232985,1576430,146809415,2019
7,20409,B6,B6,JetBlue Airways,3,60919004,0,0,18857771,18857771,79776775,60919004,18857771,79776775,127696495,0,0,39529064,39529064,167225559,127696495,39529064,167225559,2019
7,21167,CP,CP,Compass Airlines,2,0,0,0,0,0,0,0,0,0,0,0,0,0,0,0,0,0,0,2019
7,19790,DL,DL,Delta Air Lines Inc.,3,206257947,87307829,33130839,23280029,143718697,349976644,207363151,143769991,351133142,403679204,170875137,64842256,45562675,281280068,684959272,407109894,281380458,688490352,2019
7,20366,EV,EV,ExpressJet Airlines LLC,2,0,0,0,0,0,0,0,0,0,0,0,0,0,0,0,0,0,0,2019
7,20436,F9,F9,Frontier Airlines Inc.,3,25073216,0,0,1603336,1603336,26676552,25073216,1603336,26676552,47012069,0,0,3387238,3387238,50399307,47012069,3387238,50399307,2019
7,20107,FX,FX,Federal Express Corporation,3,54376496,15381075,23096897,2089891,40567863,94944359,56012289,41427349,97439638,106677000,30169000,44699000,4719000,79587000,186264000,109927000,81629159,191556159,2019
7,20368,G4,G4,Allegiant Air,3,21131147,0,0,0,0,21131147,21534807,164400,21699207,46518327,0,0,0,0,46518327,47444838,378124,47822962,2019
7,20500,G7,G7,GoJet Airlines LLC d/b/a United Express,2,0,0,0,0,0,0,0,0,0,0,0,0,0,0,0,0,0,0,2019
7,20166,GFQ,GFQ,Gulf And Caribbean Cargo,1,0,0,0,0,0,0,111751,89010,200761,0,0,0,0,0,0,302753,250802,553555,2019
7,20402,GL,GL,Miami Air International,2,0,0,0,0,0,0,156364,302210,458574,0,0,0,0,0,0,421359,814374,1235733,2019
7,19690,HA,HA,Hawaiian Airlines Inc.,3,16087016,0,7194376,0,7194376,23281392,16087016,7194376,23281392,31347956,0,13709257,0,13709257,45057213,31347956,13709257,45057213,2019
7,20370,KAQ,KAQ,Kalitta Air LLC,2,0,0,0,0,0,0,2702001,3739270,6441271,0,0,0,0,0,0,5485728,8393881,13879609,2019
7,21629,KD,KD,Western Global,2,0,0,0,0,0,0,1400576,1108388,2508964,0,0,0,0,0,0,3202909,2611665,5814574,2019
7,21634,KH,KH,Aloha Air Cargo,2,429557,0,0,0,0,429557,429557,0,429557,822598,0,0,0,0,822598,822598,0,822598,2019
7,20372,KLQ,KLQ,Kalitta Charters II,1,0,0,0,0,0,0,105957,20731,126688,0,0,0,0,0,0,270552,56333,326885,2019
7,20169,L2,L2,Lynden Air Cargo Airlines,1,251838,0,0,0,0,251838,403722,9300,413022,578466,0,0,0,0,578466,1012104,21123,1033227,2019
7,20151,M6,M6,Amerijet International,2,0,0,0,1389919,1389919,1389919,861701,1507262,2368963,0,0,0,3113867,3113867,3113867,1930489,3376753,5307242,2019
7,20398,MQ,MQ,Envoy Air,3,0,0,0,0,0,0,0,0,0,0,0,0,0,0,0,0,0,0,2019
7,20405,N8,N8,National Air Cargo Group Inc d/ba National Airlines,2,0,0,0,0,0,0,75831,819230,895061,0,0,0,0,0,0,241209,2904645,3145854,2019
7,20108,NC,NC,Northern Air Cargo Inc.,1,314989,0,0,0,0,314989,421503,0,421503,663094,0,0,0,0,663094,890009,0,890009,2019
7,20416,NK,NK,Spirit Air Lines,3,38320573,0,0,5028491,5028491,43349064,38320573,5028491,43349064,80953479,0,0,10622855,10622855,91576334,80953479,10622855,91576334,2019
7,20397,OH,OH,PSA Airlines Inc.,2,0,0,0,0,0,0,0,0,0,0,0,0,0,0,0,0,0,0,2019
7,20304,OO,OO,SkyWest Airlines Inc.,3,9566241,0,0,0,0,9566241,9566241,0,9566241,21469274,0,0,0,0,21469274,21469274,0,21469274,2019
7,20177,PFQ,PFQ,Asia Pacific,1,0,0,0,0,0,0,0,421335,421335,0,0,0,0,0,0,0,885651,885651,2019
7,20100,PO,PO,Polar Air Cargo Airways,3,2583178,604648,11253822,0,11858470,14441648,2583178,11858470,14441648,5168602,1268450,21168491,0,22436941,27605543,5168602,22436941,27605543,2019
7,19687,QX,QX,Horizon Air,2,0,0,0,0,0,0,0,0,0,0,0,0,0,0,0,0,0,0,2019
7,20422,SY,SY,Sun Country Airlines d/b/a MN Airlines,2,3762872,0,0,887445,887445,4650317,4198458,1001072,5199530,8123838,0,0,2083838,2083838,10207676,9214238,2343883,11558121,2019
7,20447,U7,U7,USA Jet Airlines Inc.,2,0,0,0,0,0,0,287984,18532,306516,0,0,0,0,0,0,597567,53308,650875,2019
7,19977,UA,UA,United Air Lines Inc.,3,163602359,76391495,54888033,33224952,164504480,328106839,164295066,164694081,328989147,318916771,149560487,106573191,68329653,324463331,643380102,320251056,324816300,645067356,2019
7,20195,WI,WI,Sky Lease Cargo,2,0,0,0,0,0,0,0,727737,727737,0,0,0,0,0,0,0,1594189,1594189,2019
7,20310,WL,WL,"Caribbean Sun Airlines, Inc. d/b/a World Atlantic Airlines",1,0,0,0,0,0,0,41492,91090,132582,0,0,0,0,0,0,120015,263476,383491,2019
7,20377,X9,X9,Omni Air International LLC,2,0,0,0,0,0,0,357883,3779166,4137049,0,0,0,0,0,0,747727,8858287,9606014,2019
7,20207,XP,XP,XTRA Airways,1,0,0,0,0,0,0,0,0,0,0,0,0,0,0,0,0,0,0,2019
7,20378,YV,YV,Mesa Airlines Inc.,2,0,0,0,0,0,0,0,0,0,0,0,0,0,0,0,0,0,0,2019
7,20452,YX,YX,Republic Airline,3,27361,0,0,0,0,27361,27361,0,27361,56688,0,0,0,0,56688,56688,0,56688,2019
7,19393,WN,WN,Southwest Airlines Co.,3,182539375,0,0,2459214,2459214,184998589,182640130,2459214,185099344,362437125,0,0,5797137,5797137,368234262,362654100,5797137,368451237,2019
8,21161,09Q,09Q,"Swift Air, LLC d/b/a Eastern Air Lines d/b/a Eastern",2,0,0,0,0,0,0,288920,691498,980418,0,0,0,0,0,0,1041710,1818583,2860293,2019
8,21352,0WQ,0WQ,Avjet Corporation,1,0,0,0,0,0,0,0,0,0,0,0,0,0,0,0,0,0,0,2019
8,21492,1BQ,1BQ,"Eastern Airlines f/k/a Dynamic Airways, LLC",1,0,0,0,0,0,0,7072,23540,30612,0,0,0,0,0,0,27652,61083,88735,2019
8,21652,27Q,27Q,"Jet Aviation Flight Services, Inc.",1,0,0,0,0,0,0,0,0,0,0,0,0,0,0,0,0,0,0,2019
8,21712,2HQ,2HQ,Elite Airways LLC,1,114588,0,0,0,0,114588,145383,0,145383,317125,0,0,0,0,317125,414672,0,414672,2019
8,21974,3EQ,3EQ,"Scott Aviation, LLC  d/b/a  Silver Air",1,0,0,0,0,0,0,0,0,0,0,0,0,0,0,0,0,0,0,2019
8,20408,5V,5V,Tatonduk Outfitters Limited d/b/a Everts Air Alaska and Everts Air Cargo,1,370652,0,0,0,0,370652,459018,0,459018,873615,0,0,0,0,873615,1084816,0,1084816,2019
8,19917,5X,5X,United Parcel Service,3,43409000,11670000,17516000,2780000,31966000,75375000,43409000,31966000,75375000,82869000,22553000,34673000,5678000,62904000,145773000,82869000,62904000,145773000,2019
8,20007,5Y,5Y,Atlas Air Inc.,3,0,0,0,0,0,0,16764718,33741803,50506521,0,0,0,0,0,0,36170901,75762297,111933198,2019
8,19874,8C,8C,Air Transport International,2,0,0,0,0,0,0,23473,778506,801979,0,0,0,0,0,0,48341,2041138,2089479,2019
8,20363,9E,9E,Endeavor Air Inc.,2,0,0,0,0,0,0,0,0,0,0,0,0,0,0,0,0,0,0,2019
8,20190,9S,9S,Southern Air Inc.,2,1251684,2364388,4516590,1848,6882826,8134510,1251684,6882826,8134510,2657455,5556135,9699503,4077,15259715,17917170,2657455,15259715,17917170,2019
8,19805,AA,AA,American Airlines Inc.,3,202894574,70336377,20270807,44174310,134781494,337676068,203192653,135003848,338196501,381039943,134812431,38814044,90720075,264346550,645386493,381593620,264788688,646382308,2019
8,20453,ABX,ABX,ABX Air Inc,2,159484,0,0,0,0,159484,159484,0,159484,0,0,0,0,0,0,0,0,0,2019
8,19930,AS,AS,Alaska Airlines Inc.,3,66006281,0,0,511217,511217,66517498,66100174,511217,66611391,137929922,0,0,1242006,1242006,139171928,138106879,1242006,139348885,2019
8,20409,B6,B6,JetBlue Airways,3,60585417,0,0,19173518,19173518,79758935,60585417,19173518,79758935,124292370,0,0,39334911,39334911,163627281,124292370,39334911,163627281,2019
8,21167,CP,CP,Compass Airlines,2,0,0,0,0,0,0,0,0,0,0,0,0,0,0,0,0,0,0,2019
8,19790,DL,DL,Delta Air Lines Inc.,3,205778169,87613874,33320826,23272261,144206961,349985130,206920890,144206961,351127851,391476743,166678488,63390244,44273642,274342374,665819117,394893012,274342374,669235386,2019
8,20366,EV,EV,ExpressJet Airlines LLC,2,0,0,0,0,0,0,0,0,0,0,0,0,0,0,0,0,0,0,2019
8,20436,F9,F9,Frontier Airlines Inc.,3,25512256,0,0,520291,520291,26032547,25512256,520291,26032547,46146191,0,0,1223415,1223415,47369606,46146191,1223415,47369606,2019
8,20107,FX,FX,Federal Express Corporation,3,57600477,15042547,23085768,2110647,40238962,97839439,59321547,41058655,100380202,108349000,28487000,44810000,4671000,77968000,186317000,111635000,79758327,191393327,2019
8,20368,G4,G4,Allegiant Air,3,15347680,0,0,0,0,15347680,16090859,119327,16210186,32802872,0,0,0,0,32802872,34499210,265855,34765065,2019
8,20500,G7,G7,GoJet Airlines LLC d/b/a United Express,2,0,0,0,0,0,0,0,0,0,0,0,0,0,0,0,0,0,0,2019
8,20166,GFQ,GFQ,Gulf And Caribbean Cargo,1,0,0,0,0,0,0,94612,158323,252935,0,0,0,0,0,0,236707,414614,651321,2019
8,20402,GL,GL,Miami Air International,2,0,0,0,0,0,0,145261,210220,355481,0,0,0,0,0,0,396679,574068,970747,2019
8,19690,HA,HA,Hawaiian Airlines Inc.,3,16136273,0,7592735,0,7592735,23729008,16190448,7592735,23783183,30475345,0,14487191,0,14487191,44962536,30576646,14487191,45063837,2019
8,20370,KAQ,KAQ,Kalitta Air LLC,2,0,0,0,0,0,0,3180454,4656457,7836911,0,0,0,0,0,0,8799806,9331809,18131615,2019
8,21629,KD,KD,Western Global,2,0,0,0,0,0,0,802348,531102,1333450,0,0,0,0,0,0,1748652,1278423,3027075,2019
8,21634,KH,KH,Aloha Air Cargo,2,423687,0,0,0,0,423687,423687,0,423687,799725,0,0,0,0,799725,799725,0,799725,2019
8,20372,KLQ,KLQ,Kalitta Charters II,1,0,0,0,0,0,0,57736,56575,114311,0,0,0,0,0,0,156971,149454,306425,2019
8,20169,L2,L2,Lynden Air Cargo Airlines,1,175233,0,0,0,0,175233,290578,18933,309511,388236,0,0,0,0,388236,668960,51135,720095,2019
8,20151,M6,M6,Amerijet International,2,0,0,0,1143201,1143201,1143201,1170963,1158873,2329836,0,0,0,2460322,2460322,2460322,2520070,2494050,5014120,2019
8,20398,MQ,MQ,Envoy Air,3,0,0,0,0,0,0,0,0,0,0,0,0,0,0,0,0,0,0,2019
8,20405,N8,N8,National Air Cargo Group Inc d/ba National Airlines,2,0,0,0,0,0,0,26529,84542,111071,0,0,0,0,0,0,95400,1441243,1536643,2019
8,20108,NC,NC,Northern Air Cargo Inc.,1,320321,0,0,0,0,320321,465418,0,465418,637138,0,0,0,0,637138,913881,0,913881,2019
8,20416,NK,NK,Spirit Air Lines,3,39098822,0,0,3725737,3725737,42824559,39098822,3725737,42824559,81114551,0,0,7729426,7729426,88843977,81114551,7729426,88843977,2019
8,20397,OH,OH,PSA Airlines Inc.,2,0,0,0,0,0,0,0,0,0,0,0,0,0,0,0,0,0,0,2019
8,20304,OO,OO,SkyWest Airlines Inc.,3,8790766,0,0,0,0,8790766,8790766,0,8790766,21267349,0,0,0,0,21267349,21267349,0,21267349,2019
8,20177,PFQ,PFQ,Asia Pacific,1,0,0,0,0,0,0,0,386916,386916,0,0,0,0,0,0,0,860924,860924,2019
8,20100,PO,PO,Polar Air Cargo Airways,3,2215213,277803,9758768,0,10036571,12251784,2215213,10036571,12251784,4305348,596347,19332871,0,19929218,24234566,4305348,19929218,24234566,2019
8,19687,QX,QX,Horizon Air,2,0,0,0,0,0,0,0,0,0,0,0,0,0,0,0,0,0,0,2019
8,20422,SY,SY,Sun Country Airlines d/b/a MN Airlines,2,5660560,0,0,465642,465642,6126202,6572865,508671,7081536,11754627,0,0,1077215,1077215,12831842,13305447,1125983,14431430,2019
8,20447,U7,U7,USA Jet Airlines Inc.,2,0,0,0,0,0,0,462203,38169,500372,0,0,0,0,0,0,924554,106556,1031110,2019
8,19977,UA,UA,United Air Lines Inc.,3,162360183,75508731,55800390,29621923,160931044,323291227,163531864,161156564,324688428,308413848,145753696,109459063,60135055,315347814,623761662,310650235,315782939,626433174,2019
8,20195,WI,WI,Sky Lease Cargo,2,0,0,0,0,0,0,0,908243,908243,0,0,0,0,0,0,0,1956967,1956967,2019
8,20310,WL,WL,"Caribbean Sun Airlines, Inc. d/b/a World Atlantic Airlines",1,0,0,0,0,0,0,50866,56582,107448,0,0,0,0,0,0,192018,213596,405614,2019
8,20377,X9,X9,Omni Air International LLC,2,0,0,0,0,0,0,446849,2916847,3363696,0,0,0,0,0,0,985794,7364118,8349912,2019
8,20207,XP,XP,XTRA Airways,1,0,0,0,0,0,0,0,0,0,0,0,0,0,0,0,0,0,0,2019
8,20378,YV,YV,Mesa Airlines Inc.,2,0,0,0,0,0,0,0,0,0,0,0,0,0,0,0,0,0,0,2019
8,20452,YX,YX,Republic Airline,3,22245,0,0,0,0,22245,22245,0,22245,46383,0,0,0,0,46383,46383,0,46383,2019
8,19393,WN,WN,Southwest Airlines Co.,3,175218927,0,0,1702372,1702372,176921299,175268660,1702372,176971032,342805103,0,0,3911530,3911530,346716633,342904670,3911530,346816200,2019
9,21161,09Q,09Q,"Swift Air, LLC d/b/a Eastern Air Lines d/b/a Eastern",2,0,0,0,0,0,0,415270,592868,1008138,0,0,0,0,0,0,1430024,1166525,2596549,2019
9,21352,0WQ,0WQ,Avjet Corporation,1,0,0,0,0,0,0,0,0,0,0,0,0,0,0,0,0,0,0,2019
9,21492,1BQ,1BQ,"Eastern Airlines f/k/a Dynamic Airways, LLC",1,0,0,0,0,0,0,76144,171305,247449,0,0,0,0,0,0,241376,543037,784413,2019
9,21652,27Q,27Q,"Jet Aviation Flight Services, Inc.",1,0,0,0,0,0,0,0,0,0,0,0,0,0,0,0,0,0,0,2019
9,21712,2HQ,2HQ,Elite Airways LLC,1,59983,0,0,0,0,59983,148395,0,148395,170051,0,0,0,0,170051,508180,0,508180,2019
9,21974,3EQ,3EQ,"Scott Aviation, LLC  d/b/a  Silver Air",1,0,0,0,0,0,0,0,0,0,0,0,0,0,0,0,0,0,0,2019
9,20408,5V,5V,Tatonduk Outfitters Limited d/b/a Everts Air Alaska and Everts Air Cargo,1,265824,0,0,0,0,265824,361624,0,361624,685649,0,0,0,0,685649,932749,0,932749,2019
9,19917,5X,5X,United Parcel Service,3,40870000,11611000,17578000,2688000,31877000,72747000,40870000,31877000,72747000,78729000,21978000,33721000,5508000,61207000,139936000,78729000,61207000,139936000,2019
9,20007,5Y,5Y,Atlas Air Inc.,3,0,0,0,0,0,0,16151077,32502107,48653184,0,0,0,0,0,0,35106509,70017869,105124378,2019
9,19874,8C,8C,Air Transport International,2,0,0,0,0,0,0,26608,792993,819601,0,0,0,0,0,0,88364,2058257,2146621,2019
9,20363,9E,9E,Endeavor Air Inc.,2,0,0,0,0,0,0,0,0,0,0,0,0,0,0,0,0,0,0,2019
9,20190,9S,9S,Southern Air Inc.,2,1483224,1806170,4563581,2382,6372133,7855357,1483224,6372133,7855357,3168937,4260364,9141496,4944,13406804,16575741,3168937,13406804,16575741,2019
9,19805,AA,AA,American Airlines Inc.,3,181813413,67638705,19477349,34306860,121422914,303236327,182204854,121649993,303854847,345924380,129770834,36726420,68621603,235118857,581043237,346653565,235586871,582240436,2019
9,20453,ABX,ABX,ABX Air Inc,2,135237,0,0,0,0,135237,135237,0,135237,0,0,0,0,0,0,0,0,0,2019
9,19930,AS,AS,Alaska Airlines Inc.,3,58265437,0,0,412339,412339,58677776,58438446,412339,58850785,124638578,0,0,1012403,1012403,125650981,124973656,1012403,125986059,2019
9,20409,B6,B6,JetBlue Airways,3,55213771,0,0,13820935,13820935,69034706,55217487,13820935,69038422,112127451,0,0,28067386,28067386,140194837,112135306,28067386,140202692,2019
9,21167,CP,CP,Compass Airlines,2,0,0,0,0,0,0,0,0,0,0,0,0,0,0,0,0,0,0,2019
9,19790,DL,DL,Delta Air Lines Inc.,3,174872651,77709987,30630186,19138771,127478944,302351595,176327569,127564141,303891710,346038440,153772717,60611089,37871849,252255655,598294095,349929240,252424244,602353484,2019
9,20366,EV,EV,ExpressJet Airlines LLC,2,0,0,0,0,0,0,0,0,0,0,0,0,0,0,0,0,0,0,2019
9,20436,F9,F9,Frontier Airlines Inc.,3,23951656,0,0,237248,237248,24188904,23951656,237248,24188904,44956844,0,0,500174,500174,45457018,44956844,500174,45457018,2019
9,20107,FX,FX,Federal Express Corporation,3,50173214,15833052,22022838,1944140,39800030,89973244,51632985,40856222,92489207,95907000,30802000,42649000,4108000,77559000,173466000,98738055,79999000,178737055,2019
9,20368,G4,G4,Allegiant Air,3,9559460,0,0,0,0,9559460,10437749,96221,10533970,20468604,0,0,0,0,20468604,22545157,216912,22762069,2019
9,20500,G7,G7,GoJet Airlines LLC d/b/a United Express,2,0,0,0,0,0,0,0,0,0,0,0,0,0,0,0,0,0,0,2019
9,20166,GFQ,GFQ,Gulf And Caribbean Cargo,1,0,0,0,0,0,0,255268,117077,372345,0,0,0,0,0,0,617906,311012,928918,2019
9,20402,GL,GL,Miami Air International,2,0,0,0,0,0,0,311216,193027,504243,0,0,0,0,0,0,841790,522107,1363897,2019
9,19690,HA,HA,Hawaiian Airlines Inc.,3,15017176,0,7545606,0,7545606,22562782,15139018,7545606,22684624,28680909,0,14159401,0,14159401,42840310,28914379,14159401,43073780,2019
9,20370,KAQ,KAQ,Kalitta Air LLC,2,0,0,0,0,0,0,2675407,3756806,6432213,0,0,0,0,0,0,5306614,8277885,13584499,2019
9,21629,KD,KD,Western Global,2,0,0,0,0,0,0,1358616,1201536,2560152,0,0,0,0,0,0,2943828,2318117,5261945,2019
9,21634,KH,KH,Aloha Air Cargo,2,390699,0,0,0,0,390699,390699,0,390699,743115,0,0,0,0,743115,743115,0,743115,2019
9,20372,KLQ,KLQ,Kalitta Charters II,1,0,0,0,0,0,0,141016,9701,150717,0,0,0,0,0,0,368715,23471,392186,2019
9,20169,L2,L2,Lynden Air Cargo Airlines,1,117491,0,0,0,0,117491,273184,60684,333868,257300,0,0,0,0,257300,614202,171374,785576,2019
9,20151,M6,M6,Amerijet International,2,0,0,0,1036569,1036569,1036569,971269,1102972,2074241,0,0,0,2247051,2247051,2247051,2105494,2390998,4496492,2019
9,20398,MQ,MQ,Envoy Air,3,0,0,0,0,0,0,0,0,0,0,0,0,0,0,0,0,0,0,2019
9,20405,N8,N8,National Air Cargo Group Inc d/ba National Airlines,2,0,0,0,0,0,0,14485,377779,392264,0,0,0,0,0,0,80523,2001703,2082226,2019
9,20108,NC,NC,Northern Air Cargo Inc.,1,279169,0,0,0,0,279169,368557,0,368557,570190,0,0,0,0,570190,747636,0,747636,2019
9,20416,NK,NK,Spirit Air Lines,3,32308811,0,0,3589868,3589868,35898679,32308811,3589868,35898679,66084009,0,0,7342668,7342668,73426677,66084009,7342668,73426677,2019
9,20397,OH,OH,PSA Airlines Inc.,2,0,0,0,0,0,0,0,0,0,0,0,0,0,0,0,0,0,0,2019
9,20304,OO,OO,SkyWest Airlines Inc.,3,8834786,0,0,0,0,8834786,8834786,0,8834786,20313626,0,0,0,0,20313626,20313626,0,20313626,2019
9,20177,PFQ,PFQ,Asia Pacific,1,0,0,0,0,0,0,0,351884,351884,0,0,0,0,0,0,0,743639,743639,2019
9,20100,PO,PO,Polar Air Cargo Airways,3,2183045,655524,9078100,0,9733624,11916669,2183045,9733624,11916669,4216942,1368117,16932957,0,18301074,22518016,4216942,18301074,22518016,2019
9,19687,QX,QX,Horizon Air,2,0,0,0,0,0,0,0,0,0,0,0,0,0,0,0,0,0,0,2019
9,20422,SY,SY,Sun Country Airlines d/b/a MN Airlines,2,3723905,0,0,33703,33703,3757608,5029452,78537,5107989,7838208,0,0,66983,66983,7905191,10675385,157036,10832421,2019
9,20447,U7,U7,USA Jet Airlines Inc.,2,0,0,0,0,0,0,457621,46047,503668,0,0,0,0,0,0,917567,128227,1045794,2019
9,19977,UA,UA,United Air Lines Inc.,3,141650742,76362770,51251749,21997143,149611662,291262404,142963521,149948902,292912423,269880307,146157283,98447438,43893813,288498534,558378841,272383646,289135932,561519578,2019
9,20195,WI,WI,Sky Lease Cargo,2,0,0,0,0,0,0,0,1083142,1083142,0,0,0,0,0,0,0,2302795,2302795,2019
9,20310,WL,WL,"Caribbean Sun Airlines, Inc. d/b/a World Atlantic Airlines",1,0,0,0,0,0,0,29403,24865,54268,0,0,0,0,0,0,19975,16892,36867,2019
9,20377,X9,X9,Omni Air International LLC,2,0,0,0,0,0,0,369977,3573437,3943414,0,0,0,0,0,0,808310,8797931,9606241,2019
9,20207,XP,XP,XTRA Airways,1,0,0,0,0,0,0,0,0,0,0,0,0,0,0,0,0,0,0,2019
9,20378,YV,YV,Mesa Airlines Inc.,2,0,0,0,0,0,0,0,0,0,0,0,0,0,0,0,0,0,0,2019
9,20452,YX,YX,Republic Airline,3,22895,0,0,0,0,22895,22895,0,22895,46818,0,0,0,0,46818,46818,0,46818,2019
9,19393,WN,WN,Southwest Airlines Co.,3,161363187,0,0,1035797,1035797,162398984,161469375,1035797,162505172,317050854,0,0,2343476,2343476,319394330,317265738,2343476,319609214,2019
